設定	设置
IPログリーダー	IP 日志阅读器
IPアドレスログ	IP 地址日志
全クリア	一切正常
IPログが全て削除されました	所有 IP 日志均已删除。
ID	身份证
タイムスタンプ	时间戳
IPアドレス	IP 地址
ユーザーエージェント	用户代理
イベント	活动
IPアドレスのデータはありません	无 IP 地址数据。
デバッグモード、コンソールの警告メッセージ	调试模式，控制台警告信息。
右クリックの警告メッセージ	右键单击警告信息。
印刷、PDF保存の警告メッセージ	打印和保存 PDF 文件时的警告信息。
スクリーンショットの警告メッセージ	截屏警告信息。
スクリーンショットの疑いの警告メッセージ	所谓的截图警告信息。
テキスト全選択時の警告メッセージ	选中所有文本时发出警告信息。
ページ保存の警告メッセージ	页面保存警告信息。
コピー・カットした時に表示するメッセージ	复印或剪切时显示信息。
HTMLソース表示時に表示するメッセージ	显示 HTML 代码时要显示的信息
HTML難読化・保護時にソースの先頭に表示するメッセージ	当 HTML 被混淆和保护时，在源代码开头显示的信息。
HTML保護時に一度限りの認証トークンが異常の場合に表示するメッセージ	如果一次性身份验证令牌在 HTML 保护过程中出现异常，则显示此消息。
CookieやJavascriptが有効でない場合に表示するメッセージ	如果 cookie 和 Javascript 未启用，则会显示信息。
実際にはJavascriptが無効時のみ表示されます	实际上，这只有在禁用 Javascript 时才能看到。
画像保護時に画像がダウンロードされ、その画像に表示するメッセージ 英語のみ	下载图像且图像受保护时图像上显示的信息 仅限英文
HTML難読化 (圧縮)	HTML 混淆（压缩）
無効	无效
有効	有效性
一般的なHTML圧縮です、難読化解除のサイトもあります	一般 HTML 压缩，有些网站有去混淆功能。
このオプションを有効にするとview-sourceのログが取得できます	启用此选项可记录视图源
HTML保護	HTML 保护
HTML圧縮以上に最小限のHTMLしか出力せず、BODYタグ内の内容が全く出力されなくなります	除 HTML 压缩外，只输出最少量的 HTML，而且根本不输出 BODY 标记中的内容。
Firefoxに対しては無効です	不适用于 Firefox。
SEOに著しく影響があります	显著影响搜索引擎优化。
HTMLをJavaScriptで描画	使用 JavaScript 渲染 HTML
Firefox対策としてHTMLをJavaScriptで描画をします	使用 JavaScript 渲染 HTML 作为 Firefox 的一项措施
JavaScript描画で有効にするとウェブサイトの表示速度が著しく遅くなります	启用 JavaScript 渲染功能会大大降低网站的显示速度
画像の保護	图像保护。
imgタグが呼び出されるごとに画像を保護	在每次调用 img 标记时保护图像。
出力される全HTMLのうち、Wordpressにアップロードされた画像をすべて保護	在所有 HTML 输出中保护上传到 Wordpress 的所有图像
画像をダウンロードから保護します	保护图像免受下载。
画像データを保護した時にはほぼ完全なるダウンロードを阻止し、完全なるワンタイムURLを発行し、セッションに保存されたトークンで認証し、phpから画像を表示します、その為ほぼ完全な画像盗用を防ぎます	当图像数据受到保护时，几乎可以完全防止下载，发布完整的一次性 URL，使用会话中存储的令牌进行身份验证，并从 php 显示图像，从而几乎完全防止图像被盗。
画像データを保護した時には画像のキャッシュが効かないため、次回訪問時にサイトの読み込みが遅くなるため、SEOに影響があります	当图像数据受到保护时，图像缓存将不起作用，因此网站在下次访问时加载速度会更慢，从而影响搜索引擎优化
画像データを保護した時には、データベースの負荷が高くなる可能性があります	保护图像数据时，数据库负载可能会更高
「imgタグが呼び出されるごとに画像を保護」の場合は、add_filterを使用し、imgタグの発行時にフィルタリングを行います、テーマによっては正しく動作しません	关于 "每次调用 img 标记时都保护图像"，请使用 add_filter 并在发布 img 标记时使用过滤器，根据主题的不同，这可能无法正常工作。
「出力される全HTMLのうち、Wordpressにアップロードされた画像をすべて保護」の場合は、Wordpressのほぼすべての動作をキャプチャし、コンテンツ内のimgタグについてすべて処理します。テーマによっては正しく動作しません	保护上传到 Wordpress 的所有图像，不包括所有 HTML 输出 "将捕获几乎所有 Wordpress 活动，并处理内容中有关 img 标记的所有内容。某些主题将无法正常运行
なお、アイキャッチに指定した画像はOGPとして拡散されますので保護できません。どうしても保護すべき場合は高度な設定でHTML保護時のHEADタグの出力の選択を変更してください	请注意，指定为醒目的图像会作为 OGP 传播，无法对其进行保护。如果必须保护，请在高级设置中更改保护 HTML 时 HEAD 标记输出的选择。
OS標準搭載のスクリーンショット機能を保護することはできません	无法保护标准操作系统截屏功能
画像URLの保護	保护图像 URL
画像の保護と組み合わせて使用します、単体では意味がありません	与图像保护结合使用，单独使用意义不大。
JavaScriptにより遅延読まれますのでSEOに影響があります	JavaScript 导致阅读延迟，影响搜索引擎优化
HTML難読化・保護時のHTMLソースコードのアスキーアートの出力	在 HTML 混淆和保护过程中输出 HTML 源代码中的 ASCII 艺术。
表示なし	无指示
view-sourceでHTMLソース表示をした時に警告の意思を示すアスキーアートを表示します	在使用 view-source 显示 HTML 源代码时，显示 ASCII 文字，表明警告的意图。
対象アクションを起こした時の表示デザイン	触发目标操作时显示设计。
黄色の背景の黒文字のベーシックデザイン	黄底黑字的基本设计
黒色の背景の赤文字のホラー風デザイン	黑底红字的恐怖风格设计。
黒色の背景の赤文字の光る文字のデザイン	黑底红字的设计。
対象アクションを起こした時のBGM	采取目标行动时的 BGM。
サウンドなし	无声
戦闘＆戦闘勝利 - 1分16.3秒 - ライセンス：CC2.1 or later	战斗和战斗胜利 - 1 分 16.3 秒 - 授权许可：CC2.1 或更高版本
おやじ ショート - 3.8秒 - ライセンス GPL2.0 or later (C)EJ	父亲短 - 3.8 秒 - 许可证 GPL2.0 或更高版本
おやじ ロング - 23.5秒 - ライセンス GPL2.0 or later (C)EJ	父亲长 - 23.5 秒 - 许可证 GPL2.0 或更高版本
ショパン エチュード Op.10-5 黒鍵 打ち込み版 高速版 - 1分0.0秒 - ライセンス：CC BY-ND 4.0 or later	肖邦练习曲，作品 10-5，黑键，打字版，快速版 - 1 分 0.0 秒 - 授权许可：CC BY-ND 4.0 或更高版本
ショパン エチュード Op.10-12 革命 打ち込み版 高速版 - 1分57.6秒 - ライセンス：CC BY-ND 4.0 or later	肖邦练习曲，作品 10-12 革命，打字版，快速版 - 1 分 57.6 秒 - 授权许可：CC BY-ND 4.0 或更高版本
ショパン スケルツォ 変ロ短調 Op2 打ち込み版 高速短縮版 - 1分48.0秒 - ライセンス：CC BY-ND 4.0 or later	肖邦降 B 小调回旋曲，作品 2，打字版，快速简版 - 1 分 48.0 秒 - 授权许可：CC BY-ND 4.0 或更高版本
ファンファーレ - 22.3秒 - ライセンス：パブリックドメイン	Fanfare - 22.3 秒 - 许可证：公有领域
レトロ風ファンファーレ - 2.2秒 - ライセンス：パブリックドメイン	复古风大合唱 - 2.2 秒 - 授权许可：公有领域
レトロ風オープン - 42.1秒 - ライセンス：パブリックドメイン	复古式开启 - 42.1 秒 - 授权许可：公有领域
警告表示中のBGMを選択します	选择警告显示时的背景音乐。
びっくりするような雰囲気を作ります	营造惊喜氛围
Firefoxでは音声ブロックされます	火狐浏览器会屏蔽音频。
対象アクションを起こした時のビープ音	采取目标行动时发出哔哔声。
有効 音量小さ目	启用 低音量
有効 音量大き目	已启用 最大声量
警告表示中にすべてのキー・マウスイベントでビープ音を鳴らします	警告显示期间，所有按键/鼠标事件都会发出蜂鸣声
警告表示中に端末が暴走したかのような雰囲気を作ります	在警告显示期间营造一种设备失控的氛围
対象アクションを起こした時のマウスカーソルの消去	执行目标操作时擦除鼠标光标。
警告表示中にブラウザのエリアのマウスカーソルを消去します	在警告显示期间清除浏览器区域的鼠标指针
デバッグモード	调试模式
妨害＋記録のみ	仅干扰+记录。
妨害＋記録＋表示＋リダイレクト	拦截 + 记录 + 显示 + 重定向
メニューからは操作できてしまいます	可通过菜单进行操作。
Firefoxにおけるデバッグモード	火狐浏览器的调试模式
ブラウザーコンソール	浏览器控制台
事実上デバッグモードから操作できてしまいます	实际上，您可以在调试模式下进行操作。
HTMLソース表示	显示 HTML 源代码
view-source:から始まるURLを入力すれば操作できてしまいます	可通过输入以 view-source: 开头的 URL 进行操作。
HTML保護と組み合わせることでコンテンツを保護することができます	结合 HTML 保护，可对内容进行保护
印刷	印刷
印刷阻止をするもものの、ブラウザによってはうまく動作しません	打印阻塞，但在某些浏览器中效果不佳
スクリーンショット	截图
OSやブラウザ、方法によっては妨害できず、もしくは検出しないことがあります	可能不会被拦截或检测到，这取决于操作系统、浏览器和方法
ウインドウが背面に移動した時スクリーンショットの疑い	当窗户移至后方时，有截图嫌疑。
あわせて、スクリーンショット以外の機能（タブ切り替え・ウィンドウ切り替え）にも反応してしまいます。	此外，它还能对屏幕截图以外的功能（标签切换、窗口切换）做出反应。
2キー押下のスクリーンショットの疑い	怀疑按两个键就能截图。
上の項目の検出方法は完全ではありません、予防的に検出を行います	上述项目的检测方法并不完善，因此采用了预防性检测。
スクリーンショットだけではなく、デバッグモード等も検出します	它可以检测屏幕截图以及调试模式等。
ページ保存	保存页面
右クリック	右击
アドオンがインストールされていると操作できてしまいます	如果安装了附加组件，就可以进行操作。
コピー・カット	复制剪切
本プラグインの設定によってはこのイベントにたどり着くことはほとんどない場合があります	根据该插件的配置，该事件可能很少发生
テキスト全選択	全文选择
テキスト選択	文本选择
デバッガー妨害	调试器干扰
デバッグモードの使い勝手を少し悪くします、ブラウザによってはこの挙動が止められてしまいます	使调试模式对用户不那么友好，有些浏览器会阻止这种行为
リダイレクトするURL	要重定向到的 URL
利用規約などのページに転送すると良いでしょう	您可能需要将他们转发到 "使用条款 "等页面。
空欄にすると元のURLにリダイレクトをします	如果留空，将重定向到原始 URL
リダイレクトまでの時間	是时候调整方向了。
リダイレクトなし	无重定向
1秒	1 秒钟
2秒	2 秒
3秒	3 秒
4秒	4 秒
5秒	5 秒
6秒	6 秒
7秒	7 秒
8秒	8 秒
9秒	9 秒
10秒	10 秒
15秒	15 秒
20秒	20 秒
25秒	25 秒
30秒	30 秒
35秒	35 秒
40秒	40 秒
45秒	45 秒
50秒	50 秒
55秒	55 秒
1分	一分钟
1分10秒	1 分 10 秒
1分20秒	1 分 20 秒
1分30秒	1 分 30 秒
1分40秒	1 分 40 秒
1分50秒	1 分 50 秒
2分	2 分钟
ソース表示を許可する権限	允许源显示的权限。
ADMINログイン時のみ通常のソース出力	仅在管理员登录时输出正常信号源
USERログインで通常のソース出力	用户登录后的正常信号源输出
通常のHTML出力を管理者のみかユーザーログインかを選択します	选择正常 HTML 输出是仅供管理员使用，还是供用户登录使用
画像を無理やりダウンロードして実際にダウンロードされるもの	通过强制下载图像实际下载了什么。
GIF形式で1×1ピクセルの透過画像	1 x 1 像素的 GIF 格式透明图像。
PNG形式で1×1ピクセルの透過画像	1 x 1 像素的 PNG 格式透明图像。
PNG形式で黄色い背景の警告画面	PNG 格式的黄色背景警告屏幕。
意味のないHTMLドキュメント	无意义的 HTML 文档
HTML保護時のHEADタグの出力	在 HTML 保护过程中输出 HEAD 标记
出力しない	无输出
TITLEタグのみ	仅 TITLE 标签
WordpressのHEADタグより取得	从 Wordpress 的 HEAD 标签中提取
企業用途の会員専用ページや社内ページなどでは「出力しない」、「TITLEタグのみ」で良いでしょう	对于企业使用的页面，如会员专享页面或内部页面，"无输出 "或 "仅 TITLE 标签 "即可。
WordpressのHEADタグから取得しないと、SNSのシェアでOGP画像が表示されません	除非 OGP 图像来自 Wordpress HEAD 标签，否则不会显示在社交网络共享中。
画像botをアクセス禁止にする	禁止图像机器人。
画像botをHTMLに対し避けることにより、画像検索から直接リンクされることによって守れなかったコンテンツを守ることができます	相对于 HTML 而言，避免图像机器人可以保护那些无法通过图像搜索直接链接保护的内容。
AI学習用botをアクセス禁止にする	禁止访问人工智能学习机器人。
AIの学習用のbotをHTMLに対し避けることにより、AIで利用されないようにします、ただし完全には対処することはできません	避免人工智能学习机器人学习 HTML，可以防止人工智能使用 HTML，但不能完全解决以下问题
alertメッセージを表示する言語	显示警报信息的语言。
Wordpressの言語	Wordpress 语言。
ブラウザの設定言語	浏览器设置语言
メッセージをカスタム設定されている場合は言語を変更できません	如果自定义了信息，则无法更改语言
view-sourceメッセージを表示する言語	显示视图源信息的语言。
一時使用トークンの有効期限	临时使用令牌的到期日。
3分	3 分钟
4分	4 分钟
5分	5 分钟
6分	6 分钟
7分	7 分钟
8分	8 分钟
9分	9 分钟
10分	10 分钟
15分	15 分钟
20分	20 分钟
25分	25 分钟
30分	30 分钟
35分	35 分钟
40分	40 分钟
45分	45 分钟
50分	50 分钟
55分	55 分钟
1時間	1 小时
画像URL情報の有効期限を設定します	设置图片 URL 信息的有效期。
一度読み込まれると画像URL情報と一時使用トークンは無効化されます	加载后，图像 URL 信息和临时使用标记将被禁用
画像は遅延読み込みされますが、この指定した時間の30秒前に強制的に画像が読み込まれます	图像将被缓慢加载，但图像将被强制在指定时间 30 秒前加载。
一時使用トークンのビット数	临时使用标记的位数
画像URL情報を暗号化するのに一時使用トークンをパスワードとして使用しますが、その強度を指定します	指定用作密码的临时使用标记的强度，以加密图像 URL 信息
ドロップダウンメニューの下に表示される選択肢にいくにつれて強度が強くなるものの、サーバーへの負荷が高くなり、HTML転送量が多くなることがあります	虽然强度会随着下拉菜单下面列出的选项的增加而增加，但服务器的负载会增加，传输的 HTML 数量也会增加
ハッシュ化アルゴリズム	散列算法
画像URL情報を暗号化するのに一時使用トークンをパスワードとして使用しますが、その時ハッシュ化が必要です、その強度を設定します	临时令牌用作密码来加密图像 URL 信息，但必须进行散列，并设置散列强度。
ドロップダウンメニューの下に表示される選択肢にいくにつれて強度が強くなるものの、サーバーへの負荷が高くなります	当您选择下拉菜单下面的选项时，强度会增加，但服务器的负载也会增加
基本設定	基本设置
高度な設定	高级设置
初期設定に戻す	重置为默认值
デザイン・音の設定	设计和音效设置
イベントの設定	事件配置。
メッセージの設定	信息设置
右クリックやソースコード表示時に転送する URL を設定します	设置右键单击或查看源代码时要转发的 URL。
警告メッセージにはHTMLは使用できません	警告信息不能使用 HTML
この画面で設定すると、高度な設定タブにある言語設定が無視されます	如果在此屏幕上设置，高级设置选项卡中的语言设置将被忽略
以下の文字列が使用できます	可以使用以下字符串
改行	新线
押下されたキー	按键
Neo HTML Protector 設定	尼欧 HTML 保护程序设置
メッセージ	留言。
デザイン・音	设计和音响
初期化	初始化
このプラグインについて	关于此插件。
設定が初期化されました	设置已初始化。
プラグインを初期化します なおIPログリーダーのデータはここでは削除されません	初始化插件 请注意，此处不会删除 IP 日志阅读器数据。
Neo HTML Protectorについて	关于 Neo HTML Protector
このプラグインはあなたのWordpressから出力されるHTMLや画像等を保護し、コンテンツの不正利用から守ることを目的としています。	该插件旨在保护 Wordpress 输出的 HTML、图片等，防止未经授权使用其内容。
コンテンツを完璧に守ることはできません。しかし可能な限りの方法において警告し、もし何かがあった場合に備えて準備することにより国で定められている方法で解決することができるはずです。	内容不可能得到完美的保护。但是，通过以各种可能的方式向他们发出警告，并在发生意外时做好准备，您应该能够以国家规定的方式解决问题。
もちろん、利用規約やサイトポリシーを充実させる必要があります。このプラグインは利用規約生成アプリではありませんが、そのヒントを与えることができます。	当然，您还需要完善您的使用条款和网站政策。这个插件不是一个使用条款生成应用程序，但它可以给你一个提示。
開発者: 夜桜　なの	开发者：Nano Yozakura
バージョン	版本
ビルド	构建
サポートページ	支持页面
ISISちゃん	ISIS chan
Miss. 裏まにら氏歌唱	乌拉马尼拉先生演唱的《小姐
支援のお願い	请求援助。
Neo HTML Protectorをご利用いただき、ありがとうございます！	感谢您使用 Neo HTML Protector！
本プラグインの開発と維持には多くの時間と知恵の絞りだしがかかっており、引き続き改善と更新を行っていくための資金を集めるために、もしご支援いただける方がいれば、寄付をお願いできればと思います。	本插件的开发和维护耗费了我们大量的时间和智慧，如果有捐赠，我们将不胜感激，以帮助我们筹集资金进行持续改进和更新。
寄付について	关于捐赠
寄付は任意であり、強制ではありません。プラグインを無料でご利用いただけるように、どなたでも利用可能です。しかし、開発を継続するためにはご支援が大変ありがたく、少しでもご協力いただけると嬉しいです。	捐赠是自愿的，不是强制性的。它对所有人开放，因此插件可以免费使用。但是，我们非常希望得到您的支持以继续开发，我们也非常乐意提供力所能及的帮助。
ご寄付は、下記のリンクから行っていただけます。日本の方であれば無料で寄付をすることも可能で、更にはアマゾンギフト券で気軽に寄付をすることが可能です。	您可以通过以下链接捐款。如果您来自日本，也可以免费捐款，此外，您还可以使用亚马逊礼券轻松捐款。
寄付先	捐助方
皆様のご支援があれば、今後も素晴らしいアップデートをお届けできるよう頑張ります！	有了您的支持，我们将尽最大努力在未来为您带来更好的更新！
ご支援いただけることに感謝し、今後ともよろしくお願いいたします。	我们感谢您的支持，并期待今后与您合作。
ライセンス	许可
本プラグインはオープンソースで開発されており、GPL2.0以降のバージョンのライセンスを適用しています。	该插件为开放源码开发，并根据 GPL 2.0 或更高版本获得许可。
本プラグインには以下のライブラリを同梱しています	该插件包含以下库
本プラグインには以下で生成したアスキーアートのフォント、並びにフォントファイルを同梱しています	该插件包括字体和字体文件，用于由
アスキーアート（AA）作成	ASCII 艺术（AA）创作
ラッコ株式会社 利用承諾取得済	Otters Ltd 使用已获同意。
巨大文字AAジェネレーター	巨型角色 AA 生成器
LAZE SOFTWARE 利用承諾取得済	已获得 LAZE 软件公司的使用许可
The Gnome Project 利用承諾取得済	获得 Gnome 项目使用许可
このプラグインには、有限会社イージェーが開発を行い、本プラグイン製作者が作曲した、スーパーファミコン非公認ゲーム「SM調教師瞳3」の楽曲が含まれており、正式にライセンスされています。当該楽曲の使用は、有限会社イージェーよりGPL2.0ライセンスの下で正式に許可を得ています	本插件包含来自未经授权的超级任天堂娱乐系统（SNES）游戏 "SM Trainer Hitomi 3 "的音乐，该游戏由 EJ Ltd. 开发，由本插件的创建者作曲，并已获得官方许可。根据 EJE Ltd. 颁发的 GPL2.0 许可，正式允许使用该音乐。
一部で使用しているピアノ音源「Keppys YAMAHA C7」は、KaleidonKep99氏が制作したSoundFontであり、ライセンス条件に従って使用しています	某些部分中使用的钢琴音源 "Keppys YAMAHA C7 "是由 KaleidonKep99 制作的 SoundFont，并根据许可条件使用。
その他本プラグインの開発にRaspberry Pi5とChatGPTとdeeplを使用しています	开发该插件时还使用了其他树莓派 5、ChatGPT 和 deepl。
キャッシュプラグインを検出しました キャッシュプラグインが有効化されていると本プラグインは正しく動作しません	检测到缓存插件 如果启用了缓存插件，此插件将无法正常工作。
無効なIPアドレス	无效 IP 地址。
このウェブサイトをご利用いただくには、CookieとJavaScriptを有効にしていただく必要があります	使用本网站必须启用 Cookie 和 JavaScript。
通常とは異なる方法でのアクセスや操作が検出されました	检测到不寻常的访问或操作方法。
セキュリティ並びにコンテンツ保護のため一部の機能を制限しています	出于安全和内容保护的考虑，某些功能受到限制。
デバッグモード、コンソールの起動は禁止されています	禁止调试模式和控制台激活
以下の情報がサーバーに送信されました	以下信息已发送至服务器
あなたのIPアドレス	您的 IP 地址
あなたの端末とブラウザ	您的设备和浏览器
あなたの押下したキー	您按下的键
リダイレクトをします	重定向。
コンテンツ保護のため一部の機能を制限しています	某些功能受到限制，以保护内容。
右クリックは禁止されています	禁止右键单击。
あなたが押下したキー	您按下的键。
印刷、PDFへの保存は禁止されています	禁止打印和保存为 PDF 格式
スクリーンショットは禁止されています	禁止截图。
スクリーンショット、デバッグモード等の起動は禁止されています	禁止激活屏幕截图、调试模式等。
ページの保存は禁止されています	禁止保存页面。
コピー、カットは禁止されています	禁止复制或剪切。
あなたが起こしたイベント	你造成的事件
テキストの選択は禁止されています	禁止选择文本。
HTMLソース表示は禁止されています	禁止显示 HTML 源代码。
不正アクセスは禁止されています	禁止未经授权的访问。
アラビア語	阿拉伯语
ブルガリア語	保加利亚语
チェコ語	捷克语
デンマーク語	丹麦语
ドイツ語	德语
現代ギリシア語	现代希腊语
英語	英语
イギリス英語	英式英语
アメリカ英語	美式英语
スペイン語	西班牙语
エストニア語	爱沙尼亚语
フィンランド語	芬兰语
フランス語	法语
ハンガリー語	匈牙利语
インドネシア語	印度尼西亚语
イタリア語	意大利语
日本語	日语
朝鮮語	韩语
リトアニア語	立陶宛语
ラトビア語	拉脱维亚语
ノルウェー語	挪威语
オランダ語	荷兰语
ポーランド語	波兰语
ポルトガリア語	葡萄牙语
ブラジルポルトガル語	巴西葡萄牙语
ヨーロピアンポルトガル語	欧洲葡萄牙语
ルーマニア語	罗马尼亚语
ロシア語	俄语
スロバキア語	斯
スロベニア語	斯洛文尼亚语
スウェーデン語	瑞典语
トルコ語	土耳其语
ウクライナ語	乌克兰语
中国語	中文
簡体中国語	简体中文
繁体中国語	繁体中文
不正なリクエストです	请求不正确。
画像が見つかりません	未找到图像。
画像botをHTMLに対し避けることにより、画像検索から直接リンクされることによって守れなかったコンテンツを守ることができます、ただし完全には対処することはできません	相对于 HTML 而言，避免图像机器人可以保护那些无法通过图像搜索的直接链接得到保护的内容，尽管这一点无法完全解决。
無効なUAをアクセス禁止にする	禁止访问无效 UA。
ユーザーエイジェントの文字に不正な文字列があった場合のアクセスを避けます	如果用户代理中存在无效字符串，则避免访问。
Internet Explorerと旧Microsoft Edgeのアクセスに警告を表示する	对 Internet Explorer 和前 Microsoft Edge 访问的警告。
Internet Explorerと旧Microsoft Edgeのアクセスを避けます	避免访问 Internet Explorer 和以前的 Microsoft Edge。
このプラグインには有限会社イージェーが開発を行い、本プラグイン製作者が作曲した、スーパーファミコン非公認ゲーム「SM調教師瞳3」の楽曲を含んでおり、正式にライセンスされています	本插件包含来自未经授权的超级任天堂娱乐系统（SNES）游戏 "SM Trainer Hitomi 3 "的音乐，该游戏由 EJ Ltd.开发，由插件创建者作曲，并已获得官方许可。
このプラグインには、Keppy氏（KaleidonKep99）によって作成された「Keppy s YAMAHA C7」を使用した楽曲が含まれており、正式にライセンスされています	本插件包含使用 Keppy
現在ご利用のブラウザーはサポート対象外の旧バージョンです。より安全で快適な閲覧環境のため、最新のブラウザーへのアップデートをお願いいたします	您当前使用的浏览器是旧版本，已不再受支持。为获得更安全、更舒适的浏览环境，请更新至最新浏览器。
戦闘＆戦闘勝利 - 1分16.3秒 - 630,056bytes - 64kbps - ライセンス：CC2.1 or later	战斗与战斗胜利 - 1 分钟 16.3 秒 - 630,056 字节 - 64 kbps - 授权许可：CC2.1 或更高版本
おやじ ショート - 3.8秒 - 32,364bytes - 64kbps - ライセンス GPL2.0 or later (C)EJ	Father Short - 3.8 秒 - 32,364bytes - 64kbps - 许可证 GPL2.0 或更高版本
おやじ ロング - 23.5秒 - 195,578bytes - 64kbps - ライセンス GPL2.0 or later (C)EJ	父亲 长 - 23.5 秒 - 195,578bytes - 64kbps - 许可证 GPL2.0 或更高版本
ショパン エチュード Op.10-5 黒鍵 打ち込み版 高速版 - 1分0.0秒 - 369,778bytes - 48kbps - ライセンス：CC BY-ND 4.0 or later	肖邦练习曲，作品 10-5，黑键，打字版本，快速版本 - 1 分钟 0.0 秒 - 369,778 字节 - 48 kbps - 授权许可：CC BY-ND 4.0 或更高版本
ショパン エチュード Op.10-12 革命 打ち込み版 高速版 - 1分57.6秒 - 724,457bytes - 48kbps -  ライセンス：CC BY-ND 4.0 or later	肖邦练习曲，作品 10-12 革命，打字版本，快速版本 - 1 分 57.6 秒 - 724,457 字节 - 48 kbps - 授权许可：CC BY-ND 4.0 或更高版本
ショパン スケルツォ 変ロ短調 Op2 打ち込み版 高速短縮版 - 1分48.0秒 - 665,369bytes - 48kbps - ライセンス：CC BY-ND 4.0 or later	肖邦降 B 小调回旋曲，作品 2，打字版本，快速简版 - 1 分 48.0 秒 - 665,369 字节 - 48 kbps - 许可协议：CC BY-ND 4.0 或更高版本
ファンファーレ - 22.3秒 - 183,926bytes - 64kbps - ライセンス：パブリックドメイン	Fanfare - 22.3 秒 - 183,926 字节 - 64 kbps - 许可证：公有领域
レトロ風ファンファーレ - 2.2秒 - 10,536bytes - 32kbps - ライセンス：パブリックドメイン	复古风大合唱 - 2.2 秒 - 10,536 字节 - 32 kbps - 许可证：公有领域
レトロ風オープン - 42.1秒 - 179,138bytes - 32kbps - ライセンス：パブリックドメイン	复古式开放 - 42.1 秒 - 179 138 字节 - 32 kbps - 许可证：公有领域
Internet Explorerと旧Microsoft Edge(EdgeHTML)のアクセスに警告を表示する	针对 Internet Explorer 和前 Microsoft Edge
警告 by ChatGPT - 3.8秒 - 109,700bytes - 256kbps - ライセンス：パブリックドメイン	Alert by ChatGPT - 3.8 seconds - 109,700bytes - 256kbps - 许可证：公有领域
マルウェア検出みたいな緊急感の高い音 その１ by ChatGPT - 3.3秒 - 102,850bytes - 256kbps - ライセンス：パブリックドメイン	听起来急需恶意软件检测 第 1 部分：ChatGPT - 3.3 秒 - 102,850bytes - 256kbps - 许可证：公有领域
マルウェア検出みたいな緊急感の高い音 その２ by ChatGPT - 3.3秒 - 103,122bytes - 256kbps - ライセンス：パブリックドメイン	听起来像恶意软件检测第二部分，非常紧急，作者：ChatGPT - 3.3 秒 - 103,122bytes - 256kbps - 授权：公有领域
MRI風サウンド by ChatGPT - 1分14.9秒 - 2,157,371bytes - 256kbps - ライセンス：パブリックドメイン	MRI-style sound by ChatGPT - 1 分 14.9 秒 - 2,157,371 字节 - 256 kbps - 授权许可： 公有领域
MRI風サウンド by ChatGPT - 1分14.9秒 - 3,340,392bytes - 320kbps - ライセンス：パブリックドメイン	MRI-style sound by ChatGPT - 1 min 14.9 sec - 3,340,392 bytes - 320 kbps - 许可证：公有领域
このウェブサイトでは、利用規約違反や不正アクセスの検知・防止を目的として、ユーザーのIPアドレス、閲覧履歴、一部操作ログをCookieおよびデータベースに保存し、必要に応じて警告を行う場合があります。これらの情報は、サイトの健全な運営および法的トラブル対策以外には一切使用いたしません。\n同意されない場合は、これらの目的を達成するためにサービスの提供が困難となるため、閲覧をご遠慮いただく場合があります。	本网站可能会将用户的 IP 地址、浏览记录和某些操作日志保存在 Cookie 和数据库中，以便检测和防止违反使用条款和未经授权的访问，并在必要时发出警告。除保证网站正常运行和防止出现法律问题外，这些信息不会用于其他目的。\如果您不同意，我们可能会要求您不要浏览本网站，因为这将使我们难以提供服务以实现这些目的。
同意する	同意。
同意しない	不同意。
確認	证实
このウェブサイトでは、利用規約違反や不正アクセスの検知・防止を目的として、ユーザーのIPアドレス、閲覧履歴、一部操作ログをCookieおよびデータベースに保存し、必要に応じて警告を行う場合があります。これらの情報は、サイトの健全な運営および法的トラブル対策以外には一切使用いたしません。同意されない場合は、これらの目的を達成するためにサービスの提供が困難となるため、閲覧をご遠慮いただく場合があります。	本网站可能会将用户的 IP 地址、浏览历史记录和某些操作日志保存在 Cookie 和数据库中，以检测和防止违反使用条款和未经授权的访问，并在必要时发出警告。除保证网站正常运行和防止出现法律问题外，这些信息不会用于任何其他目的。如果您不同意，我们可能会要求您停止浏览本网站，因为这将使我们难以提供服务以实现上述目的。
このウェブサイトでは、不正アクセスの防止や利用規約違反の検知を目的に、IPアドレス、閲覧履歴、操作ログをCookieおよびデータベースに保存することがあります。これらの情報は、サイト運営および法的対応以外では使用せず、第三者には提供しません。	本网站可能会将 IP 地址、浏览历史和操作日志保存在 Cookie 和数据库中，以防止未经授权的访问并检测违反使用条款的行为。除网站运营和法律通信外，这些信息不会用于任何其他目的，也不会转交给第三方。
サービスの利用には、これらのデータ処理に同意する必要があります。不同意の場合、サービスの利用が制限されます。ご同意いただくことで、プライバシーポリシーを確認できます。	要使用服务，您必须同意处理这些数据。如果您不同意，您的服务使用将受到限制。同意后，您可以查看隐私政策。
プライバシーポリシー	隐私政策。
EU GDPR対応	欧盟 GDPR 合规性
EU圏内でWordpressを使用するには必ず有効にしてください	在欧盟使用 Wordpress 时必须启用
確認のボタンが同意する、同意しないのボタンになります	确认按钮变为 "同意 "或 "不同意 "按钮。
お知らせの1行目	通知第 1 行。
お知らせの2行目	通知第 2 行。
非EU向け確認の文字列	非欧盟国家的确认字符串
EU GDPR向け同意するの文字列	欧盟 GDPR 的同意条款
EU GDPR向け同意しないの文字列	欧盟 GDPR 的一系列分歧
プライバシーポリシーの文字列	隐私政策字符串
プライバシーポリシーのURLはこちらから設定して下さい	请在此处设置您的隐私政策 URL
利用規約を設定する場合、必ずプライバシーポリシーに利用規約のリンクを設置して下さい	如果您设置了 "使用条款"，请务必在 "隐私政策 "中设置 "使用条款 "链接
検索エンジン等のURL	搜索引擎的 URL 等。
同意しなかった時に画面遷移する検索エンジンなどのURLを設定します	设置搜索引擎和其他搜索引擎的 URL，当用户不同意时，屏幕会切换到这些 URL。
初回訪問時のお知らせの設定	为首次访问设置通知。
お知らせ	通知
プライバシーポリシーには不正操作を検知するためにCookieとデータベースに保存されることを追加して下さい	在隐私政策中加入 Cookie 和数据库的存储，以检测未经授权的操作
プライバシーポリシーには以下の内容を追加して下さい	请在隐私政策中添加以下内容
・不正操作検知のため、CookieおよびデータベースにIPアドレス等の識別子を保存する。保存されたデータは、管理者の任意のタイミングで削除を行う。	为进行篡改检测，IP 地址和其他标识符将存储在 cookies 和数据库中。存储的数据可由管理员随时删除。
・画像保護が有効な場合のみ、画像を正常に保存するため、IPアドレスと画像ファイル名をハッシュ化したデータをデータベースに最大60分間保存する。	只有在启用图像保护时，IP 地址和图像文件名的散列数据才会在数据库中存储长达 60 分钟，以便成功存储图像。
不正操作検知のため、CookieおよびデータベースにIPアドレス等の識別子を保存する。保存されたデータは、管理者の任意のタイミングで削除を行う。	为检测未经授权的操作，数据库中会存储 Cookie 和 IP 地址等标识符。管理员可随时删除存储的数据。
画像保護が有効な場合のみ、画像を正常に保存するため、IPアドレスと画像ファイル名をハッシュ化したデータをデータベースに最大60分間保存する。	只有启用了图像保护，IP 地址和图像文件名的哈希值才会被保存在数据库中长达 60 分钟，以便成功存储图像。
画像保護が有効な場合のみ、画像を正常に配信するため、IPアドレスと画像ファイル名をハッシュ化したデータをデータベースに最大60分間保存する。	只有启用了图像保护，IP 地址和图像文件名的散列数据才会在数据库中保存长达 60 分钟，以便成功传送图像。
このサイトでは、不正防止や規約順守のため、IPアドレス、閲覧履歴、操作ログをCookieおよびデータベースに保存することがあります。これらはサイト運営および法的対応以外では使用せず、第三者には提供しません。	本网站可能会将 IP 地址、浏览历史和操作日志保存在 Cookie 和数据库中，以防止欺诈并遵守条款和条件。这些信息仅用于网站运营和法律通信，不会透露给第三方。
サービスの利用には、これらのデータ処理に同意する必要があります。不同意の場合、サービスの利用が制限されます。	要使用服务，您必须同意处理这些数据。如果不同意，则服务的使用将受到限制。
このサイトでは、不正利用の防止や規約の順守を目的に、IPアドレス・閲覧履歴・操作ログなどの情報をCookieとデータベースに保存することがあります。これらの情報は、サイトの運営や法的対応にのみ使用され、第三者に提供することはありません。	本网站可能会在 Cookie 和数据库中存储 IP 地址、浏览历史和操作日志等信息，以防止未经授权的使用并遵守条款和条件。这些信息仅用于网站运行和法律通信，不会透露给第三方。
サービスの利用には、これらのデータ処理への同意が必要です。不同意の場合、サービスのご利用ができません。	使用本服务必须征得同意才能处理这些数据。如果未经同意，则无法使用服务。
初回表示で必ず表示されるメッセージです	此信息始终显示在第一个显示屏上。
EU GDPRが有効の際のみ初回表示で必ず表示されるメッセージです	只有启用欧盟 GDPR 时，该信息才会始终显示在首次显示屏上。
お知らせの3行目	通知第 3 行。
プライバシーポリシーのリンクの右側に表示されます	它出现在隐私政策链接的右侧
ご同意いただくことで、プライバシーポリシーを確認できます。	同意后，您可以查看隐私政策。
同意画面の色	同意屏幕的颜色。
自動	自动
ライトモード	灯光模式
ダークモード	暗模式
同意画面表示中の配色を設定します	在显示 "同意 "屏幕时设置颜色方案。
同意画面中のコンテンツのぼかし	同意屏幕上的内容模糊不清。
なし	不带
同意画面表示中のコンテンツのぼかし具合を設定します	设置同意屏幕显示时内容的模糊程度。
同意画面の透過	同意屏幕的透明度。
透過なし	不透明
同意画面の透過具合を設定します	设置同意屏幕的透明度。
EU圏内でWordpressを使用する場合、並びにEU圏内を対象とするには必ず有効にしてください	必须能够在欧盟使用 Wordpress，并以欧盟国家为目标市场。
